111111111111111111111
1P0000000000000100001
101111111111111100001
100000000000CE0100001
100000000000000100001
100000000000000100001
100000000000000100001
100000000000000100001
100000000000000100001
100000000000000100001
100000000000000100001
100000000000000100001
100000000000000100001
100000000000000100001
100000000000000100001
100000000000000100001
100000000000000100001
100000000000000100001
100000000000000100001
100000000000000100001
100000000000000100001
100000000000000100001
100000000000000100001
100000000000000100001
111111111111111111111
