111111
1P0001
101101
1C0C01
1010E1
111111
