11111111111111111111
1P000000000001000001
10111111111110101101
10000000000000100001
10101111111111111001
1C0010000000000000C1
10111110111111111001
10000000100000000001
10111111101111111001
1C0000000010000000E1
10111111111110101101
11111111111111111111
