1111111111111111111111111
1001000000001000000000001
1000011111001000000000001
1P0011E000001000000000001
1001000000001000000000001
1001000000001000000000001
1001000000001000000000001
1001000000001000000000001
1001000000001000000000001
1000000000001000000000001
1001000000001000000000001
1001000000001000000000001
1001000000001000000000001
1001000000000000000000001
1001000000000000000000001
1000000000000000000000C01
1111111111111111111111111
